███████████████████████████████████████
█ █       █         █       █         █
█ █████ █ █ █████ █ ███ ███ █ ███ █████
█ █   █ █   █     █     █   █   █     █
█ █ █ █████ █ ███████████ █████ █████ █
█   █     █ █ █     █   █   █   █     █
█████████ █ █ █ ███ █ █ ███ █ ███ ███ █
█       █ █ █ █   █ █ █     █   █   █ █
█ █ █████ █ █ ███ █ █ █████████ ███ ███
█ █ █   █ █ █   █ █ █     █   █   █   █
█ ███ █ █ █ ███ ███ █████ ███ ███ ███ █
█   █ █   █ █   █       █   █     █   █
███ █ ███████ ███ █████████ ███████ ███
█   █         █ █         █       █   █
█ █████████████ █ █████ █████████ ███ █
█   █       █     █     █       █     █
█ █ █ █ █████ █████ █████ █ █████████ █
█ █   █           █       █           █
███████████████████████████████████████
