███████████
█ █       █
█ █████ █ █
█ █   █ █ █
█ █ █ ███ █
█   █     █
█████████ █
█ █     █ █
█ █ █ ███ █
█   █     █
███████████
